#,#,#,#,#,#,#,#,#,#,#,#,#,#
#,-,-,-,-,-,-,-,-,-,-,-,-,#
#,-,*,*,*,*,*,*,*,*,*,*,-,#
#,-,*,-,-,-,-,-,-,-,-,*,-,#
#,-,*,-,*,*,*,*,*,*,-,*,-,#
#,-,*,-,*,-,-,-,-,*,-,*,-,#
#,-,*,-,*,-,-,-,-,*,-,*,-,#
#,-,*,-,*,-,-,-,-,*,-,*,-,#
#,-,*,-,*,-,-,-,-,*,-,*,-,#
#,-,*,-,*,*,*,*,*,*,-,*,-,#
#,-,*,-,-,-,-,-,-,-,-,*,-,#
#,-,*,*,*,*,*,*,*,*,*,*,-,#
#,-,-,-,-,-,-,-,-,-,-,-,-,#
#,#,#,#,#,#,#,#,#,#,#,#,#,#