#,#,#,#,#,#,#,#,#,#
#,-,-,-,*,-,-,-,*,#
#,-,#,#,-,#,#,#,-,#
#,-,#,-,-,-,-,#,-,#
#,-,#,*,#,#,-,#,-,#
#,*,#,-,#,#,-,#,-,#
#,-,#,-,-,#,-,#,-,#
#,-,#,#,-,#,-,#,-,#
#,-,-,-,-,#,-,-,-,#
#,#,#,#,#,#,#,#,#,#