#,#,#,#,#,#,#,#,#,#,#,#,#,#
#,-,-,-,*,-,-,-,*,-,-,*,-,#
#,-,#,#,-,#,#,#,-,*,-,#,-,#
#,-,#,-,-,-,-,#,-,#,-,#,-,#
#,-,#,*,#,#,-,#,-,#,-,#,*,#
#,*,-,-,#,#,*,-,-,#,-,#,-,#
#,-,#,-,-,#,-,#,-,#,-,#,-,#
#,-,-,#,-,-,-,#,*,-,-,#,-,#
#,*,-,-,-,#,-,-,-,#,*,-,-,#
#,-,#,-,#,#,-,#,#,#,-,-,-,#
#,-,#,-,-,#,-,-,-,#,-,#,#,#
#,-,#,*,-,#,-,#,-,#,-,#,*,#
#,*,-,-,-,#,-,-,-,#,-,-,-,#
#,#,#,#,#,#,#,#,#,#,#,#,#,#